 5  2  2  2  2  2  2  2  2  2  2  2  2  2  2  2  2  2  2  2  2  2  2  2  2  2  2  2  2  6
 1 16 12 12 12 12 12 12 12 12 12 12 12 12 12 12 12 12 12 12 12 12 12 12 12 12 12 12 12  1
 1 12  5  2  2  2  2  2  2  2  2  2 12  2  2  2  2  2  2  2  2  2  2 12  2  2  2  6 12  1
 1 12  1 12 12 12 12 12 12 12 12 12 12 12 17 12 12 12 12 12 12 12 12 12 12 12 12  1 12  1
 1 12  1 12  5  2  2 12  2  2  2  2  2  2  2  2  2  2 12  2  2  2  2  2  2  6 12  1 12  1
 1 12  1 12  1 12 12 12 12 12 12 12 12 12 12 12 12 12 12 12 12 12 12 12 12  1 12  1 12  1
 1 12  1 12  1 12  5  2  2  2  2  2  2  2  2  2  2  2  2  2  2  2  2  6 12  1 12  1 12  1
 1 12  1 12  1 12  1 12 12 12 12 12 12 12 12 12 12 12 12 12 12 12 12  1 12  1 12  1 12  1
 1 12  1 12  1 12 12 12  5  2  2  2  2  2  2 12  2  2  2  2  2  6 12  1 12  1 12  1 12  1
 1 12  1 17  1 12  1 12  1 12 12 12 12 12 12 18 12 12 12 12 12  1 12  1 12 12 17  1 12  1
 1 12  1 12  1 12  1 12  1 12  5  2  2  2  6 12  5  2  2  6 15  1 12  1 12  1 12  1 12  1
 1 12  1 12  1 12  1 12  1 12  4  2  2  2  7 12  4  2  2  8  2  7 12  1 12  1 12  1 12  1
 1 12  1 12  1 12  1 12  1 12 12 12 12 12 12 12 12 12 12 12 12 12 12  1 12  1 12  1 12  1
 1 12  1 12 12 12  1 12  4  2  2  2  2  2  2  2  2  2  2  2  2  2  2  7 12  1 12  1 12  1
 1 12  1 12  1 12  1 12 12 12 12 12 12 12 12 12 12 12 12 12 12 12 12 12 12  1 12  12 12  1
 1 12  1 12  1 12  4  2  2  2  2  2  2 12  2  2  2  2  2  2  2  2  2  2  2  7 12  1 12  1
 1 12  1 12  1 12 12 12 12 12 12 12 12 12 12 12 12 12 12 12 12 12 12 12 12 12 12  1 12  1
 1 12 14 12  4 12  2  2  2  2  2  2  2  2  2  2  2  2  2  2  2  2  2 12  2  2  2  7 12  1
 1  0  1 12 12 12 12 12 12 12 12 12 12 12 17 12 12 12 12 12 12 12 12 12 12 12 12 12 16  1
 4  2  8  2  2  2  2  2  2  2  2  2  2  2  2  2  2  2  2  2  2  2  2  2  2  2  2  2  2  7