5  2  2 10  2  2  2  2  2  2  2  2  2 10  2  2  2  2  2  2  2  2  2  2  2  2  2  2  2  6
1 16 12  1 12 12 12 12 12 12 12 12 12  1 18 12 12 12 12 12 12 12 12 12 12 12 12 12 12 14
9  2  2  7 12  1 12  1 12  1 12  1 12  4  2  2  2  2  6 12  5  2  2  2  2  2  2  2  2 11
1 12 12 12 12  1 12  1 12  1 12  1 12 12 12 12 12 12  1 12  4  2  2 10  2  2  2 11 12  1
9  2  2  6 12  1 12  1 12  1 12  1 12  5  2  2  2 12  1 12 12 12 12  9  2  6 12  1 12  1 
9  2  2  7 12 12 12  1 12  1 12  1 12  1 12 12 12 12  1 12 12 12 12  1 12  1 16  1 12  1
1 12 12 12 12 12 12  1 12  1 12  1 12  1 12  5  2  2  7 12 12 12 12  1 12  1 12  1 12  1
1 12  5  2  2 12  2  7 12  1 12  4  2 11 12  1 12 12 12 12 12 12 12  1 12  1 12  1 12  1
1 12  1 18 12 12 12 12 12 12 12 12 12  1 12  1 12  5  2  2  2  2 12  1 12  4  2  7 12  1
1 12  4  2  2  6 12 12 12 12 12 12 12  1 12  1 12  1 12 12 12 12 12 12 12 12 12 12 12  1
1 12 12 12 12  1 12 12 12 12  5  2  2 11 12  1 12  4  2  2  2  2  6 12 12 12 12 12 12  1
9  2  2  6 12  1 12 12  1 12  1 12 12  1 12  1 12 12 12 12 12 12  9  2  2  2  2  2  2 11 
9  2  6  1 12  4  2  2 11 12  1 12 18  1 12  1 12  5  6 12 12 12  1 12 12 12 12 12 12  1
1 12  1  1 12 12 12 12  1 12  1 12 12  1 12  1 12  1  1 12 12 12  4  2  2  2  2  2  2 11
1 12  1  4  2  2  6 12  1 12  4  2  2  7 12  4  2 11  4  2  6 12 12 12 12 12 12 12 12  1
1 12  4  2  2  2  7 12  1 12 12 12 12 12 12 12 12  1 18 12  9  2  2  2  2  2  2  6 12  1
1 12 12 12 12 12 12 12  4  2 10  2  2  2  2  6 12  1 12 12  1 12 12 12 12 18 12 1  12  1
1 12  5  6 12  1 12 12 12 12  9  2  2  2  2  7 12  4  2  2  8  2  2  2  2  2  2  7 12  1
1  0  1  1 12  9  2  2  6 12  1 12 12 12 12 12 12 12 12 12 12 12 12 12 12 12 12 12 15  1
4  2  8  8  2  8  2  2  8  2  8  2  2  2  2  2  2  2  2  2  2  2  2  2  2  2  2  2  2  7